6 4 0 21 0 21 0 21 0 21 0 21 1 17 1 17 1 17 0 21 1 17 1 17 1 17 1 17 1 17 1 17 0 21 0 21 0 21 1 17 1 17 1 17 1 17 0 21 0 21 0 21 0 21 1 17 1 17 1 17 1 17 0 21 0 21 1 17 1 17 1 17 1 17 0 21 0 21 0 21 0 21 0 21 0 21 1 17 1 17 1 17 0 21 0 21 0 21 0 21 1 17 0 21 0 21 0 21 0 21 0 21 0 21 0 21 0 21 1 17 1 17 0 21 0 21 0 21 0 21 0 21 0 21 0 21 0 21 0 21 0 21 0 21 0 21 0 21 1 17 1 17 0 21 0 21 0 21 1 5 1 3 1 7 0 21 0 21 0 21 0 21 0 21 0 21 0 21 0 21 1 17 0 21 0 21 0 21 1 1 0 19 1 2 1 5 1 3 1 3 1 3 1 3 1 7 0 21 0 21 1 17 0 21 0 21 0 21 1 1 2 19 1 2 1 1 0 19 0 19 0 19 3 19 1 2 0 21 0 21 1 17 0 21 0 21 0 21 1 1 0 19 1 2 1 1 0 19 0 19 1 9 1 4 1 8 0 21 0 21 0 21 0 21 0 21 1 5 1 12 0 19 1 2 1 6 1 11 0 19 1 2 0 21 0 21 0 21 0 21 0 21 0 21 0 21 1 1 0 19 0 19 1 10 1 3 1 12 0 19 1 2 0 21 0 21 0 21 0 21 0 21 0 21 0 21 1 1 0 19 0 19 0 19 0 19 0 19 0 19 1 2 0 21 0 21 0 21 0 21 0 21 0 21 0 21 1 6 1 4 1 4 1 4 1 11 0 19 0 19 1 2 0 21 0 21 0 21 0 21 0 21 0 21 0 21 0 21 0 21 0 21 0 21 1 6 1 4 1 4 1 8 0 21 0 21 0 21 0 21 0 21 0 21 0 21 0 21 0 21 0 21 0 21 0 21 0 21 0 21 0 21 0 21 0 21 0 21 0 21 0 21 0 21 0 21 0 21 0 21 0 19 0 19 0 21 0 21 0 21 0 21 0 21 0 21 0 21 0 21 0 21 0 21 0 21 0 21 0 19 0 19 0 19 0 21 0 21 0 19 0 19 0 19 0 21 0 21 0 21 0 21 0 21 0 21 0 19 0 19 1 18 0 19 0 19 0 19 0 19 1 18 0 19 0 19 0 21 0 21 0 21 0 21 0 19 0 19 1 18 1 18 1 18 1 18 1 18 1 18 1 18 0 19 0 19 0 19 0 21 0 21 0 21 0 21 0 19 0 19 0 19 0 19 0 19 0 19 0 19 1 18 0 19 0 19 0 19 0 19 0 21 0 21 0 21 0 19 0 19 0 21 0 21 0 21 0 19 0 19 0 19 0 19 0 19 0 19 0 19 0 19 0 21 0 19 0 19 0 21 0 21 0 21 0 21 0 19 0 19 0 19 0 21 0 21 0 21 0 19 0 19 0 21 0 19 0 21 0 21 0 21 0 21 0 21 0 21 0 19 0 19 0 21 0 21 0 21 0 21 0 21 0 21 0 21 0 21 0 21 0 21 0 21 0 21 0 21 0 19 0 19 0 19 0 21 0 21 0 21 0 21 0 21 0 21 0 21 0 21 0 21 0 21 0 21 0 21 0 21 0 19 0 19 0 19 0 21 0 21 0 21 
10 6 0 21 0 21 0 21 0 21 0 21 0 21 0 21 0 21 0 21 0 21 0 19 0 19 0 19 0 19 0 19 0 21 0 21 0 21 0 21 0 21 0 21 0 21 0 21 0 21 0 21 0 21 0 19 0 19 1 18 0 19 0 21 0 21 0 21 1 17 0 21 0 21 0 21 0 21 0 21 0 21 0 21 0 21 0 19 0 19 0 19 0 21 0 21 0 21 0 21 0 21 0 21 0 21 0 21 0 21 0 21 1 17 0 21 0 21 0 19 0 19 0 21 0 21 0 21 0 21 0 21 0 21 0 21 0 21 0 21 0 21 0 21 0 21 0 21 0 19 0 19 0 21 0 21 0 21 0 21 0 21 0 21 0 21 0 21 0 21 0 21 0 21 0 21 0 21 0 21 0 19 0 21 0 21 0 21 0 21 0 21 1 5 1 3 1 3 1 3 1 7 0 21 0 21 0 21 0 21 0 19 0 21 0 21 0 21 0 21 0 21 1 1 0 19 3 19 3 19 1 2 0 21 0 21 0 21 0 21 0 19 0 21 0 21 0 21 0 21 0 21 1 1 0 19 3 19 1 16 1 10 1 7 0 21 0 21 0 21 0 21 0 21 0 21 0 19 0 21 0 21 1 1 0 19 0 19 2 19 0 19 1 2 0 21 0 21 0 21 0 21 0 21 0 21 0 19 0 19 0 21 1 1 0 19 2 19 2 19 0 19 1 2 0 21 0 21 0 21 0 21 0 21 0 19 0 19 0 19 0 21 1 1 0 19 0 19 0 19 0 19 1 2 0 21 0 21 0 21 0 21 0 19 0 19 1 18 0 19 0 19 1 6 1 4 1 4 1 4 1 4 1 8 0 21 0 21 0 21 0 21 0 21 0 19 0 19 0 19 0 21 0 21 0 21 0 21 0 21 0 21 0 21 0 21 0 21 0 21 0 21 0 21 0 21 0 19 0 21 0 21 0 21 0 21 0 21 0 21 0 21 0 21 0 21 0 21 0 21 0 21 0 21 0 21 0 21 0 21 0 21 0 21 0 21 0 21 0 21 0 21 0 21 0 21 0 21 0 21 0 19 0 21 0 21 0 21 0 21 0 21 0 21 0 21 0 21 0 21 0 21 0 21 0 21 0 21 0 19 0 19 0 21 1 17 1 17 1 17 1 17 1 17 1 17 1 17 1 17 1 17 0 21 1 17 1 18 1 18 0 19 0 19 1 17 1 17 1 18 1 18 1 17 1 17 0 21 0 21 0 21 0 19 1 18 1 18 0 19 0 19 0 19 0 19 0 19 1 17 1 17 0 21 0 21 0 21 0 21 0 21 0 21 0 19 0 19 0 19 0 21 0 19 0 19 0 21 0 21 0 21 0 21 0 21 0 21 0 21 0 21 0 21 0 21 0 21 0 21 0 21 0 19 0 21 0 21 0 21 0 21 0 21 0 21 0 21 0 21 0 21 0 21 0 21 0 21 0 21 0 21 0 19 0 21 0 21 0 21 0 21 0 21 0 21 0 21 0 21 0 21 0 21 0 21 0 21 0 21 0 21 0 19 0 21 0 21 0 21 0 21 0 21 0 21 0 21 0 21 0 21 0 21 0 21 0 21 0 21 0 21 0 21 0 21 0 21 0 21 0 21 0 21 0 21 0 21 0 21 0 21 0 21 0 21 0 21 0 21 0 21 
12 3 0 21 0 21 0 21 0 21 0 21 0 21 0 21 0 21 0 21 0 21 0 21 0 21 0 21 0 21 0 21 0 21 0 21 0 21 0 21 0 21 0 21 2 21 0 21 0 21 0 21 0 21 0 21 0 21 0 21 0 21 0 21 0 21 0 21 0 21 0 21 2 21 2 21 0 21 0 21 0 21 0 21 0 21 0 21 0 21 0 21 0 21 0 21 0 21 0 21 2 21 2 21 0 21 0 21 0 21 0 21 0 21 0 21 0 21 0 21 0 21 0 21 0 21 0 21 0 21 0 21 0 21 0 21 0 21 0 21 0 21 0 21 0 21 1 17 0 21 0 21 0 21 0 21 0 21 0 21 0 21 0 21 0 21 0 21 0 21 0 21 1 17 0 21 0 21 0 21 0 19 0 21 2 21 0 21 0 21 1 5 1 3 1 3 1 7 0 21 0 21 0 21 0 21 0 21 0 19 0 19 0 21 0 21 0 21 0 21 1 1 0 19 0 19 1 10 1 7 0 21 0 21 0 21 0 21 0 19 0 19 0 21 0 21 0 21 0 21 1 1 3 19 0 19 0 19 1 2 0 21 0 21 0 21 0 21 0 19 0 19 0 21 0 21 0 21 0 21 1 1 3 19 0 19 0 19 1 2 0 21 0 21 0 21 0 19 0 19 0 19 0 21 0 21 0 21 1 5 1 12 1 16 0 19 1 16 1 10 1 3 1 3 1 7 0 19 0 19 0 19 0 21 1 5 1 3 1 12 0 19 0 19 0 19 0 19 0 19 1 18 3 19 1 2 0 21 0 19 0 19 0 21 1 1 0 19 0 19 0 19 1 16 2 19 1 18 0 19 1 18 0 19 1 2 0 21 0 19 0 19 0 21 1 1 0 19 0 19 0 19 0 19 0 19 0 19 0 19 1 18 0 19 1 2 0 21 0 19 0 19 0 21 1 6 1 11 0 19 1 9 1 11 0 19 0 19 1 9 1 11 0 19 1 2 0 21 0 19 0 19 0 21 0 21 1 1 0 19 1 10 1 12 1 18 0 19 1 10 1 12 0 19 1 2 0 21 0 19 0 19 0 21 0 21 1 1 0 19 0 19 0 19 2 19 0 19 2 19 0 19 0 19 1 2 0 21 0 19 0 19 0 21 0 21 1 1 0 19 0 19 0 19 1 9 1 4 1 11 0 19 0 19 1 2 0 21 0 19 0 19 0 21 0 21 1 6 1 4 1 4 1 4 1 8 0 21 1 6 1 4 1 4 1 8 0 21 0 19 0 19 0 21 0 21 0 21 0 21 0 21 0 21 0 21 0 19 0 19 0 21 0 21 0 21 1 17 0 19 1 16 0 21 0 21 0 21 0 21 0 21 0 21 0 19 0 19 0 19 0 19 0 19 0 19 0 19 1 16 1 18 0 21 0 21 0 21 0 21 1 16 1 16 0 19 0 19 0 19 0 19 0 19 0 19 0 19 1 16 1 18 0 21 0 21 0 19 0 19 1 16 0 19 0 19 0 19 0 19 0 19 0 19 1 16 1 16 1 16 1 18 0 19 0 19 0 19 0 19 0 19 0 19 0 19 0 19 0 19 0 19 1 16 1 18 1 16 1 16 1 16 0 19 0 19 0 19 0 19 0 19 0 19 0 19 0 19 0 19 1 16 1 16 1 16 1 18 1 16 1 16 
9 8 0 21 0 21 0 21 0 21 0 21 0 21 0 21 0 21 1 17 1 17 1 17 1 17 1 17 1 17 1 17 0 21 0 21 0 21 0 21 0 21 0 21 0 21 0 21 0 21 0 21 0 21 1 17 1 17 1 17 1 17 0 21 0 21 0 21 0 21 0 21 0 21 0 21 0 21 0 21 0 21 0 21 0 21 1 17 1 17 1 17 0 21 0 21 0 21 0 21 0 21 0 21 0 21 0 21 0 21 0 21 0 21 0 21 0 21 1 17 1 17 0 21 0 21 0 21 0 21 1 13 1 4 1 4 1 11 0 21 0 21 0 21 0 21 0 21 0 21 1 17 0 21 0 21 0 21 1 13 1 8 0 21 0 21 1 1 0 21 0 21 0 21 0 21 0 21 0 21 1 17 0 21 0 21 0 21 1 2 0 21 0 21 3 21 1 6 1 11 0 21 0 21 0 21 0 21 0 21 1 17 0 21 0 21 0 21 1 2 0 21 0 21 3 21 0 21 1 1 0 21 0 21 0 21 0 21 0 21 1 17 0 21 0 19 0 19 1 10 1 7 0 21 1 17 0 21 1 6 1 11 0 21 0 21 0 21 0 21 0 21 0 21 0 19 0 19 0 19 1 2 0 21 2 21 2 21 0 21 1 1 0 21 0 21 0 21 0 21 0 21 0 19 0 19 0 19 0 19 1 2 0 21 0 21 0 21 0 21 1 1 0 21 0 21 0 21 0 21 0 21 0 19 0 19 0 19 0 19 1 10 1 3 1 3 1 3 1 3 1 12 0 21 0 21 0 21 0 21 0 21 0 19 0 19 0 19 0 19 0 19 0 19 0 19 0 19 0 21 0 21 0 21 0 21 0 21 0 21 0 21 1 18 1 18 0 19 0 19 0 19 1 16 1 16 0 19 0 19 0 21 0 21 0 21 0 21 0 21 0 21 1 16 1 18 1 18 0 19 0 19 0 19 1 16 1 16 0 19 0 19 0 21 0 21 0 21 0 21 0 21 1 18 1 16 1 18 1 16 0 19 0 19 0 19 1 16 0 19 0 19 0 21 0 21 0 21 0 21 0 21 1 18 1 18 1 18 1 16 1 16 0 19 1 16 1 16 0 19 0 19 0 21 0 21 0 21 0 21 0 21 1 16 1 18 1 18 0 19 0 19 1 16 1 16 0 19 1 9 1 4 1 11 0 21 0 21 0 21 0 21 1 18 1 18 0 19 0 19 0 19 0 19 0 19 1 9 1 8 0 21 1 1 0 21 0 21 0 21 0 21 0 19 0 19 0 19 0 19 0 19 0 19 0 19 1 2 5 21 0 21 1 6 1 11 0 21 0 21 0 21 0 19 0 19 0 19 0 19 0 19 0 19 0 19 1 2 0 21 0 21 0 21 1 1 0 21 0 21 0 21 0 19 0 19 0 19 0 19 0 19 1 9 1 4 1 8 2 21 0 21 0 21 0 23 0 21 0 21 0 21 0 19 0 19 0 19 0 21 0 21 1 2 1 17 1 17 2 21 2 21 0 21 1 1 0 21 0 21 0 21 0 19 0 19 0 19 0 21 0 21 1 14 1 3 1 3 1 3 1 3 1 3 1 12 0 21 0 21 0 21 0 21 0 21 0 21 0 21 0 21 0 21 0 21 0 21 0 21 0 21 0 21 0 21 0 21 0 21 0 21 
5 7 0 21 0 21 0 21 0 21 0 19 0 19 0 19 0 19 0 19 0 21 0 21 0 21 0 21 0 21 0 21 2 21 0 21 0 21 1 17 0 21 1 18 0 19 0 19 0 21 0 21 0 21 0 21 0 21 0 21 0 21 0 21 2 21 0 21 0 21 1 17 0 21 0 19 0 21 0 21 0 21 0 21 0 21 0 21 0 21 0 21 0 21 0 21 0 21 0 21 0 21 0 21 0 21 0 21 0 21 0 21 0 21 0 21 1 17 0 21 0 21 0 21 0 21 0 21 0 21 1 5 1 3 1 3 1 3 1 3 1 7 0 21 2 21 0 21 0 21 0 21 0 21 0 21 0 21 0 21 1 1 0 19 3 19 0 19 0 19 1 2 0 21 2 21 0 21 0 21 0 21 0 21 0 21 0 21 0 21 1 1 0 19 2 19 0 19 0 19 1 2 0 21 0 21 2 21 0 21 0 21 0 21 0 21 0 21 0 21 1 1 1 16 0 19 1 16 1 16 1 2 0 21 0 21 0 21 0 21 0 21 0 21 0 21 0 21 0 21 1 1 0 19 0 19 3 19 0 19 1 2 0 21 0 21 0 21 0 21 0 21 0 21 0 21 0 21 0 21 1 1 0 19 0 19 2 19 0 19 1 2 0 21 0 21 0 21 0 21 0 19 0 21 0 21 0 21 0 21 1 1 1 16 1 16 0 19 1 16 1 2 0 21 0 21 0 21 0 21 0 19 0 21 0 21 0 21 0 21 1 1 0 19 0 19 3 19 0 19 1 2 0 21 0 21 0 21 0 21 0 19 0 21 0 21 0 21 0 21 1 1 0 19 0 19 2 19 0 19 1 2 0 21 0 21 0 21 0 19 0 19 0 21 0 21 0 21 0 21 1 1 1 16 1 16 0 19 1 16 1 2 0 21 0 21 5 21 0 19 0 19 0 21 0 21 0 21 0 21 1 1 0 19 3 19 0 19 0 19 1 2 0 21 0 21 0 19 0 19 0 19 0 21 0 21 0 21 0 19 1 1 0 19 2 19 0 19 0 19 1 2 0 21 0 21 0 19 0 19 0 19 0 21 0 21 0 19 0 19 1 6 1 4 0 21 1 4 1 4 1 8 0 21 0 19 0 19 1 16 0 19 0 21 0 21 0 19 0 19 1 9 1 4 0 21 1 4 1 4 1 11 0 19 0 19 0 19 0 19 0 19 0 21 0 21 0 19 0 19 1 2 0 21 0 21 0 21 0 21 1 1 0 19 1 9 1 4 1 11 0 19 0 21 0 19 0 19 0 19 1 2 0 21 0 21 0 21 0 21 0 23 0 19 1 2 0 21 1 1 0 19 0 19 1 18 0 19 0 19 1 2 0 21 0 21 0 21 0 21 1 1 0 19 1 2 0 21 0 23 0 19 0 19 0 19 0 19 0 19 1 10 1 3 1 3 1 3 1 3 1 12 0 19 1 2 0 21 1 1 0 19 0 21 0 19 0 19 0 19 0 19 0 19 0 19 0 19 0 19 0 19 0 19 1 10 1 3 1 12 0 19 0 21 0 19 0 19 0 19 0 19 0 19 2 19 2 19 0 19 0 19 1 16 0 19 0 19 0 19 0 19 0 21 0 19 0 19 0 19 0 19 0 19 0 19 0 19 0 19 0 19 0 19 0 19 0 19 0 19 0 19 
